%%%%%%%%%%%%%%%
%.    %%%%%%% %
%     %    .% %
%     % %%% % %
%     % %%% % %
% %%%%% %%% % %
% %         % %
% % %%% %%%%% %
% %o%%%P%     %
% % %%% %     % 		
% %  o .%     %
% %%%%%%%     %		
%%%%%%%%%%%%%%%