%%%%%%%%%%%%%%%
%.    %%%%%%% %
%     %     % %
%     % %%% % %
%     %o%%%.% %
% %%%%% %%% % %
% %    o    % %
% % %%% %%%%% %
% % %%% %     %
% % %%% %     % 		
% %.   P%     %
% %%%%%%%     %		
%%%%%%%%%%%%%%%