%%%%%%%%%%%%%%%%%%%%%%%%%%%%%%%%%%%%%%
%           w        w          w   P%
% %%%%%%%%%%%%%%%%%%% %%%  %%%%%%%%  %
% %%   %   %   w  %%% %%%    %%      %
% %% % % % % %%%% %%%%%%%%%  %%  %%%%%
% %% % % % % %    %%         %%      %
% %% % % % % % %%%%%  %%%    %%%%%%  %
% %% % % %   %    %%  %%%%%%%%%      % 
% %% % % %%%%%%%% %%         %%  %%%%%
% %% %   %%    w  %%%%%%%%%  %%      %
%    %%% %% %%%%%%%      %%  %%%%%%  %
%%%%%%      %       %    %%  %%      %
%      %%%%%% %%   %%    %%  %%  %%%%%
% %%%%%%      %       %%%%%  %%  w   %
%          %%%%       %%%%%  %%%%%%  %
%%%%%%%%   %     w           %%%%%%  %
%.         %%%%%%%%%%%%%%%%     w    %
%%%%%%%%%%%%%%%%%%%%%%%%%%%%%%%%%%%%%%