%%%%%%%%%%%%%%%%%%%%
%o...%........%....%
%.%%.%.%%%%%%.%.%%.%
%.%.....w........%.%
%.%.%%.%%  %%.%%.%.%
%......%    %......%
%.%.%%.%%%%%%.%%.%.%
%.%..............%.%
%.%%.%.%%%%%%.%.%%.%
%....%...P.w..%...o%
%%%%%%%%%%%%%%%%%%%%
