%%%%%%%%%%%%%%%%%%%%
%.   %  . .   %    %
% %% % %%%%%% % %% %
% %   w          % %
% % %% %%  %% %% % %
%  w   % .  %    . %
% % %% %%%%%% %% % %
%.%              % %
% %% % %%%%%% % %% %
%    %   P.   %   o%
%%%%%%%%%%%%%%%%%%%%
